34 34 34 34 34 34 34 34 34 34 34 34 34 34 34 34 34 34 34 34 34 34 34 34 34 34 34 34 34 34 34 34 34 34 34 34 34 34 34 34 34 34 34 34 34 34 34 34 34 34 
34 34 34 34 34 34 34 34 34 34 34 34 34 34 34 34 34 34 34 34 34 34 34 34 34 34 34 34 34 34 34 34 34 34 34 34 34 34 34 34 34 34 34 34 34 34 34 34 34 34 
34 34 34 34 34 34 34 34 34 34 34 34 34 34 34 34 34 34 34 34 34 34 34 34 34 34 34 34 34 34 34 34 34 34 34 34 34 34 34 34 34 34 34 34 34 34 34 34 34 34 
34 34 34 34 34 34 34 34 34 34 34 34 34 34 34 34 34 34 34 34 34 34 34 34 34 34 34 34 34 34 34 34 34 34 34 34 34 34 34 34 34 34 34 34 34 34 34 34 34 34 
34 34 34 34 34 34 34 34 34 34 34 34 34 34 34 34 34 34 34 34 34 34 34 34 34 34 34 34 34 34 34 34 34 34 34 34 34 34 34 34 34 34 34 34 34 34 34 34 34 34 
34 34 34 34 34 34 34 34 34 34 34 34 34 34 34 34 34 34 34 34 34 34 34 34 34 34 34 34 34 34 34 34 34 34 34 34 34 34 34 34 3 5 34 34 34 34 34 34 34 34 
34 34 34 34 34 34 34 34 34 34 34 34 34 34 34 34 34 34 34 34 34 34 34 34 34 34 34 34 34 34 34 34 34 34 34 34 34 3 4 4 19 19 5 34 34 34 34 34 34 34 
34 34 34 34 34 34 34 34 34 34 34 34 34 34 34 34 34 34 34 34 34 34 34 34 34 34 34 34 34 34 34 34 34 34 34 34 34 21 19 19 19 19 41 34 34 34 34 34 34 34 
34 34 34 34 34 34 34 34 34 34 34 34 34 34 34 34 34 34 34 34 34 34 34 3 5 34 34 34 34 34 34 34 34 34 34 3 4 19 19 19 19 41 34 34 34 34 34 34 34 34 
34 34 34 34 34 34 34 34 34 34 34 34 34 34 3 4 5 34 34 34 34 3 4 28 28 4 4 4 4 5 34 34 3 4 4 19 19 19 19 19 23 34 34 34 34 34 34 34 34 34 
34 34 34 34 34 34 34 34 34 34 34 34 34 34 21 22 28 4 4 4 4 61 28 28 28 28 28 28 28 28 4 4 133 28 19 19 19 19 19 19 23 34 34 34 34 34 34 34 34 34 
34 34 34 34 34 34 34 34 6 34 34 34 34 3 134 19 19 19 19 19 19 61 28 28 28 115 28 28 28 28 28 28 28 28 28 19 44 40 40 40 137 5 34 34 34 34 34 34 34 34 
34 34 34 34 34 34 34 34 147 4 4 5 34 21 19 19 19 19 19 19 44 28 28 28 28 28 28 28 28 28 43 40 28 28 22 19 23 34 34 34 21 41 34 34 34 34 34 34 34 34 
34 34 34 34 34 34 34 34 39 28 28 28 4 28 28 28 28 28 28 154 61 28 28 28 22 28 28 28 28 28 23 34 39 40 28 28 137 5 34 34 42 34 34 34 34 34 34 34 34 34 
34 34 34 34 34 34 34 34 34 39 28 28 28 28 28 28 28 116 28 28 28 108 110 28 28 28 28 28 28 28 23 34 34 34 39 28 28 19 5 34 34 34 34 34 34 34 34 34 34 34 
34 34 34 34 34 34 34 34 34 34 21 28 28 28 28 28 154 28 28 28 131 163 146 28 28 28 28 154 28 28 23 34 34 34 34 21 28 28 19 5 34 34 34 34 34 34 34 34 34 34 
34 34 34 34 34 34 34 34 34 34 21 19 28 28 28 28 28 28 28 28 28 164 28 28 115 28 28 28 28 28 28 10 10 10 10 28 28 28 28 23 34 34 34 34 34 34 34 34 34 34 
34 34 34 34 34 34 34 34 34 3 62 19 19 19 28 28 28 28 28 115 28 146 28 28 28 28 28 28 28 19 28 28 28 22 28 28 19 28 28 23 34 34 34 34 34 34 34 34 34 34 
34 34 34 34 34 34 34 34 3 62 19 19 19 19 28 28 28 28 28 28 28 28 28 28 28 28 19 19 19 19 19 28 28 28 28 19 19 19 19 23 34 34 34 34 34 34 34 34 34 34 
34 34 34 34 34 34 34 34 39 62 19 19 19 19 19 28 28 28 28 28 28 28 19 19 28 19 19 19 19 19 19 19 19 19 28 19 19 19 19 19 4 5 34 34 34 34 34 34 34 34 
34 34 34 34 34 34 34 34 34 21 19 19 19 19 19 28 28 28 19 28 19 19 19 19 19 19 19 28 28 44 19 19 19 19 19 19 28 28 28 19 19 23 34 34 34 34 34 34 34 34 
34 34 34 34 34 34 34 34 34 39 62 19 19 19 19 28 28 28 19 19 19 19 19 19 19 19 131 40 40 40 131 19 19 19 19 43 40 40 40 40 19 41 34 34 34 34 34 34 34 34 
34 34 34 34 34 34 34 34 34 34 39 62 19 19 28 28 28 28 19 19 19 19 19 19 131 40 41 34 34 34 21 28 19 19 19 23 34 34 34 34 42 34 34 34 34 34 34 34 34 34 
34 34 34 34 34 34 34 34 34 34 34 21 19 19 19 19 28 19 19 19 19 19 19 44 23 34 34 34 34 34 21 19 19 19 19 44 5 34 34 34 34 34 34 34 34 34 34 34 34 34 
34 34 34 34 34 34 34 34 34 34 34 39 62 19 19 28 28 19 19 19 19 19 19 19 43 4 4 4 4 4 131 19 19 19 19 19 44 10 5 34 34 34 34 34 34 34 34 34 34 34 
34 34 34 34 34 34 34 34 34 34 34 34 21 19 19 28 19 19 19 19 19 19 19 19 19 19 19 19 19 19 19 19 19 19 19 19 19 19 19 4 5 34 34 34 34 34 34 34 34 34 
34 34 34 34 34 34 34 34 34 34 34 34 21 62 28 28 19 19 19 19 19 19 19 19 19 19 19 19 19 19 19 19 19 19 19 19 19 19 19 19 23 34 34 34 34 34 34 34 34 34 
34 34 34 34 34 34 34 34 34 34 34 34 21 28 28 19 19 19 19 19 19 19 19 19 19 19 19 19 19 19 19 19 19 19 19 19 19 19 19 19 119 5 34 34 34 34 34 34 34 34 
34 34 34 34 34 34 34 34 34 34 34 3 62 131 28 19 19 19 19 19 19 19 19 19 19 19 19 19 19 19 19 19 19 19 19 19 19 19 19 19 19 23 34 34 34 34 34 34 34 34 
34 34 34 34 34 34 34 34 34 34 3 22 137 28 28 19 19 19 19 19 19 19 19 19 19 19 19 19 19 19 19 19 19 19 19 19 19 19 19 19 19 23 34 34 34 34 34 34 34 34 
34 34 34 34 34 34 34 34 34 34 21 28 137 28 19 19 19 19 19 19 19 19 19 19 19 19 19 19 19 19 19 28 28 19 19 28 28 28 19 19 22 41 34 34 34 34 34 34 34 34 
34 34 34 34 34 34 34 34 34 34 21 28 137 28 19 19 19 19 19 19 19 19 19 19 19 19 19 19 28 28 28 28 28 28 28 108 110 28 19 19 23 34 34 34 34 34 34 34 34 34 
34 34 34 34 34 34 34 34 34 34 49 31 28 28 28 28 44 113 113 19 19 19 19 19 19 19 54 28 28 28 28 28 28 28 28 144 146 28 19 151 41 34 34 34 34 34 34 34 34 34 
34 34 34 34 34 34 34 34 34 34 49 49 49 31 32 132 132 132 31 134 144 56 19 19 19 54 115 28 28 28 28 28 28 28 28 28 28 28 19 23 34 34 34 34 34 34 34 34 34 34 
34 34 34 34 34 34 34 34 34 3 62 49 49 49 49 132 114 114 49 49 31 36 37 37 55 146 28 28 28 19 19 19 28 28 28 28 28 28 19 23 34 34 34 34 34 34 34 34 34 34 
34 34 34 34 34 34 34 34 3 62 62 19 19 49 49 132 114 114 49 49 49 31 44 28 28 28 28 28 19 19 19 19 19 19 19 19 28 28 154 23 34 34 34 34 34 34 34 34 34 34 
34 34 34 34 34 34 34 3 62 62 19 19 19 19 54 28 28 28 18 49 49 49 31 22 28 28 28 28 19 19 19 19 19 19 19 19 28 28 32 49 34 34 34 34 34 34 34 34 34 34 
34 34 34 34 34 34 3 62 62 19 19 19 19 54 61 28 22 108 92 19 19 49 49 31 28 28 28 19 19 19 19 19 19 19 19 28 32 49 49 49 34 34 34 34 34 34 34 34 34 34 
34 34 34 34 34 3 62 62 62 19 19 54 55 38 61 28 108 92 19 19 28 28 49 49 49 31 28 28 28 28 28 28 28 22 28 32 49 49 77 34 34 34 34 34 34 34 34 34 34 34 
34 34 34 34 34 34 62 19 19 19 54 146 61 98 113 108 92 19 28 40 40 40 40 49 49 49 49 49 31 28 22 28 28 28 32 49 49 34 34 34 34 34 34 34 34 34 34 34 34 34 
34 34 34 34 34 34 19 19 19 54 146 28 28 28 108 92 19 28 41 34 34 34 34 34 34 49 49 49 49 49 49 31 28 32 49 49 34 34 34 34 34 34 34 34 34 34 34 34 34 34 
34 3 4 4 62 34 34 34 34 90 109 110 136 108 92 19 28 41 34 34 34 34 34 34 34 34 34 34 49 49 49 49 49 49 50 34 34 34 34 34 34 34 34 34 34 34 34 34 34 34 
4 62 62 19 19 19 34 34 34 34 19 90 110 92 19 28 41 34 34 34 34 34 34 34 34 34 34 34 34 34 34 49 49 49 34 34 34 34 34 34 34 34 34 34 34 34 34 34 34 34 
62 62 19 19 19 34 19 19 34 34 19 19 19 19 28 41 34 34 34 34 34 34 34 34 34 34 34 34 34 34 34 34 34 34 34 34 34 34 34 34 34 34 34 34 34 34 34 34 34 34 
28 19 19 19 19 34 34 19 19 34 34 34 19 28 41 34 34 34 34 34 34 34 34 34 34 34 34 34 34 34 34 34 34 34 34 34 34 34 34 34 34 34 34 34 34 34 34 34 34 34 
28 19 19 19 19 19 19 34 34 19 34 34 34 41 34 34 34 34 34 34 34 34 34 34 34 34 34 34 34 34 34 34 34 34 34 34 34 34 34 34 34 34 34 34 34 34 34 34 34 34 
28 19 19 19 19 19 19 34 19 19 28 34 34 34 34 34 34 34 34 34 34 34 34 34 34 34 34 34 34 34 34 34 34 34 34 34 34 34 34 34 34 34 34 34 34 34 34 34 34 34 
28 28 19 19 19 19 19 19 19 28 41 34 34 34 34 34 34 34 34 34 34 34 34 34 34 34 34 34 34 34 34 34 34 34 34 34 34 34 34 34 34 34 34 34 34 34 34 34 34 34 
28 28 28 19 19 19 19 28 28 41 34 34 34 34 34 34 34 34 34 34 34 34 34 34 34 34 34 34 34 34 34 34 34 34 34 34 34 34 34 34 34 34 34 34 34 34 34 34 34 34 
28 28 28 28 28 28 28 28 23 34 34 34 34 34 34 34 34 34 34 34 34 34 34 34 34 34 34 34 34 34 34 34 34 34 34 34 34 34 34 34 34 34 34 34 34 34 34 34 34 34 
