477,477,477,477,37,37,37,37,37,37,37,37,37,37,37,37,38,477,477,477,477,477,477,477,477,477,477,477,477,477,477,477,477,477,477,477,477,477,477,477,477,477,477,477,477,477,477,477,477,477
477,477,111,111,110,75,110,74,111,75,111,111,111,111,75,110,75,110,75,75,75,75,110,110,74,74,110,110,74,110,75,75,74,75,75,74,75,111,75,75,366,367,368,369,369,369,294,295,296,297
477,477,110,74,75,110,75,74,111,110,75,110,111,75,74,74,111,110,74,74,111,75,110,136,74,74,111,110,110,110,111,111,74,110,110,110,111,110,75,111,74,74,366,367,368,369,294,295,296,297
477,111,74,75,110,110,75,75,110,75,74,111,75,75,75,111,75,110,110,74,612,229,144,99,217,218,219,220,219,220,221,110,75,74,110,111,74,74,74,74,75,75,74,110,75,366,294,295,296,297
477,75,75,74,75,110,506,507,507,396,653,654,655,81,545,110,74,111,75,566,505,410,256,43,44,45,43,44,255,256,257,161,110,74,74,74,75,110,110,74,74,75,75,74,75,74,330,331,332,333
37,111,111,74,75,506,507,507,543,688,689,690,691,43,43,307,341,191,43,303,43,43,43,79,80,81,43,44,45,195,293,221,159,74,75,75,543,110,111,110,74,74,75,75,74,74,366,367,294,295
37,75,111,75,111,506,507,543,652,653,654,655,185,79,79,43,43,43,43,43,79,79,79,115,116,117,43,44,45,231,256,257,195,74,75,75,75,543,111,111,110,74,75,75,74,74,75,111,294,295
37,74,111,110,506,507,507,48,688,689,690,691,57,115,115,79,43,79,79,80,81,115,115,151,152,153,43,44,45,267,268,506,507,74,75,74,75,75,75,75,75,543,75,75,110,74,75,111,294,294
37,75,75,75,506,507,543,376,298,653,132,253,596,151,151,115,79,79,79,80,81,151,151,302,303,304,79,80,81,303,304,542,543,74,75,74,74,543,111,651,75,543,75,75,75,74,75,74,330,294
37,74,110,75,506,507,632,376,377,80,81,52,360,618,632,151,115,79,80,81,81,151,151,338,339,340,115,116,117,339,340,542,74,74,75,75,75,74,75,111,543,75,75,75,111,74,75,75,366,330
37,110,74,75,542,506,507,376,377,80,81,73,80,79,80,81,79,80,81,81,117,43,632,374,158,159,151,152,153,375,376,542,110,74,74,75,75,75,543,543,111,111,75,75,75,74,75,75,110,366
37,74,75,74,75,506,507,376,377,80,81,62,116,115,116,79,80,81,81,117,153,79,80,410,194,195,196,197,410,411,412,542,543,110,74,74,75,543,506,506,75,75,75,75,75,74,75,75,74,40
37,74,75,110,111,506,507,376,377,79,80,81,293,151,152,115,116,117,117,153,79,79,80,81,81,231,232,233,446,447,448,542,543,507,110,74,74,543,75,506,506,111,111,75,75,75,75,74,110,40
37,74,75,110,111,506,507,376,79,80,81,81,80,79,79,80,81,153,153,115,115,79,80,81,117,267,268,269,482,483,484,446,542,543,507,110,543,111,75,75,75,75,75,75,111,75,75,111,74,40
37,74,74,110,111,506,507,376,79,80,81,117,116,115,115,116,117,153,79,80,81,80,81,117,153,303,304,305,518,519,520,482,542,543,543,507,543,111,111,74,74,75,506,506,111,111,111,111,111,40
37,74,110,110,111,542,506,507,79,80,81,153,79,151,151,152,153,151,115,116,117,116,117,153,153,339,340,341,79,80,81,518,519,542,543,543,507,110,111,75,74,74,74,506,110,111,75,75,110,40
37,74,110,111,506,507,507,507,79,80,79,79,115,151,152,153,152,153,151,152,79,80,81,590,374,375,376,377,115,116,117,554,555,556,542,543,543,110,111,111,75,110,74,506,506,110,111,74,111,40
37,74,110,111,506,507,507,543,79,79,115,332,332,151,152,153,152,44,45,46,115,116,117,81,410,411,412,413,151,152,153,590,591,592,543,542,543,543,110,111,111,75,110,74,74,75,111,75,74,40
37,74,110,111,506,507,543,377,115,332,332,332,368,153,80,116,152,80,81,82,151,152,153,117,446,447,448,449,44,44,44,44,44,45,46,80,542,543,543,507,110,111,75,110,74,75,111,110,111,651
37,74,110,111,506,507,376,377,332,332,368,368,80,116,116,152,152,116,117,118,151,152,153,153,482,483,484,485,80,80,80,80,80,44,44,45,46,542,543,543,110,111,111,75,74,75,75,111,110,40
37,74,110,111,480,481,331,331,368,368,368,332,332,332,332,331,331,332,331,331,332,333,334,335,444,445,446,521,314,116,116,116,380,381,381,380,381,380,381,543,543,110,111,111,74,75,75,110,110,40
37,74,110,111,516,517,367,332,332,368,368,368,368,368,368,367,331,331,367,367,368,369,370,371,522,523,522,523,331,331,331,331,331,331,332,333,334,380,381,381,381,381,110,111,75,75,111,110,75,40
37,74,110,111,552,553,332,368,368,78,80,79,79,79,45,46,367,367,367,368,369,370,371,387,480,481,480,481,367,367,367,367,367,331,331,332,333,334,380,380,380,381,381,111,111,75,111,75,75,40
37,74,110,111,506,507,368,332,332,78,78,80,79,79,79,79,79,79,79,79,79,79,79,79,79,583,584,585,1610612750,1610612786,122,380,380,380,380,380,380,381,371,380,380,380,381,381,111,74,75,75,74,40
37,74,110,111,506,507,368,332,332,332,78,78,79,78,79,118,152,152,369,369,369,369,369,369,618,619,620,621,369,369,369,122,122,56,57,195,195,380,380,380,380,381,380,381,381,75,75,75,111,40
37,74,110,111,506,507,376,368,332,332,78,78,79,152,153,154,369,369,369,369,104,104,104,104,104,104,104,104,104,105,369,369,369,92,93,231,195,195,231,195,82,380,380,380,381,111,75,111,74,76
37,74,110,111,506,507,376,377,368,368,78,79,79,369,369,369,369,104,104,104,140,140,140,140,140,140,140,140,104,104,104,105,369,207,314,-1073741658,231,195,196,231,195,196,402,403,404,111,75,75,111,112
37,74,110,111,506,507,377,377,369,369,369,369,369,369,104,104,104,140,140,140,141,104,105,105,105,105,105,105,140,140,104,104,105,243,350,-1073741694,-1073741695,195,196,195,195,196,438,439,440,111,75,74,111,148
37,74,110,111,506,507,377,413,369,104,104,104,105,104,140,140,140,141,380,379,104,105,105,141,141,141,141,141,105,105,140,104,105,369,386,-1073741730,-1073741731,195,195,231,195,196,474,475,476,111,75,75,74,40
477,74,110,111,506,507,43,44,369,369,104,140,141,140,140,141,345,380,380,379,104,105,141,344,344,104,104,140,141,141,105,105,105,369,314,-1610612607,-1610612643,195,231,232,195,196,510,511,512,111,75,75,111,40
477,74,110,111,506,507,79,43,44,369,140,141,105,141,105,345,380,379,379,104,105,105,344,344,104,140,140,140,140,140,141,141,105,382,350,-1610612606,-1610612642,231,231,46,195,196,546,547,548,111,75,74,110,40
477,74,110,111,506,507,115,79,80,369,369,104,104,105,104,104,105,105,105,105,105,141,104,104,140,141,105,105,104,104,105,105,104,382,382,-536870490,-536870526,-536870562,-536870598,82,195,196,1610613217,1610613253,1610613289,111,75,74,111,40
477,74,110,111,506,507,230,115,116,233,369,140,140,141,105,105,105,141,141,141,141,344,140,140,141,104,104,104,140,140,141,141,104,104,382,382,382,382,105,69,231,232,1610613216,1610613252,1610613288,74,75,111,75,40
477,75,110,111,506,507,230,231,232,233,369,369,104,105,141,141,141,140,104,104,105,344,140,141,104,140,140,140,140,141,369,369,140,104,104,104,104,104,105,105,69,70,46,366,367,368,75,110,111,40
477,75,110,111,506,507,230,231,232,43,44,369,104,105,344,344,344,344,140,140,104,104,105,379,140,140,141,369,369,369,369,369,369,140,140,104,105,105,105,105,105,106,82,402,403,404,111,74,75,40
477,75,75,111,506,507,38,38,38,38,39,369,104,105,344,344,344,344,344,344,344,344,344,344,344,141,105,369,128,128,128,128,128,128,129,140,141,141,141,141,105,494,495,438,439,440,75,75,75,40
477,75,75,75,506,76,74,74,74,74,288,-1610612286,104,104,105,344,344,344,344,344,344,380,140,104,104,344,344,344,344,369,344,344,344,128,128,129,491,492,105,141,494,495,495,474,475,476,74,74,110,40
145,75,75,75,506,112,110,110,110,110,324,-1610612285,140,104,104,104,104,105,380,380,344,344,380,140,140,140,141,141,105,369,369,369,344,344,494,494,494,495,141,494,495,495,531,510,511,512,74,74,74,40
145,75,75,75,506,507,146,146,146,146,147,369,369,140,140,140,104,104,104,104,104,104,104,104,104,104,140,141,105,104,105,369,369,1610612963,530,530,494,494,494,494,495,531,567,546,547,548,110,110,74,40
543,75,543,543,543,507,374,338,339,340,43,44,369,369,369,369,140,140,140,140,140,140,140,140,140,140,140,141,141,104,104,105,369,227,566,566,530,530,494,495,495,567,233,491,455,75,110,110,75,40
75,543,75,75,543,543,543,43,43,43,79,80,4,43,44,369,369,369,369,369,369,369,369,369,369,369,369,369,369,140,140,141,369,290,290,266,566,566,494,495,531,269,269,46,455,110,110,75,75,40
145,543,543,75,506,506,543,79,79,79,115,116,40,79,80,43,44,369,302,303,304,305,80,80,152,152,152,152,369,369,369,369,369,128,129,302,303,304,530,531,567,305,46,46,455,110,110,110,110,40
145,74,75,111,542,506,507,543,543,115,115,116,40,115,116,79,80,369,361,362,363,364,365,152,361,362,363,364,128,129,129,148,128,129,129,338,195,195,566,567,341,341,82,82,76,74,75,111,74,40
145,74,75,111,506,506,506,542,543,507,507,507,39,40,3,115,116,369,397,398,399,400,401,53,152,398,399,400,128,128,129,129,129,129,129,129,231,231,232,303,361,362,363,364,365,111,111,110,75,40
145,74,74,75,542,542,542,542,543,543,543,543,39,40,3,4,3,3,74,74,74,74,74,74,53,74,74,148,148,195,195,195,195,231,128,129,232,412,361,361,397,398,399,400,401,74,75,74,75,40
145,110,74,74,542,543,507,543,543,74,74,74,74,75,39,40,39,39,74,110,110,110,110,110,110,110,110,111,148,361,362,363,364,365,232,446,447,448,397,397,397,398,399,400,401,456,110,111,111,40
145,110,110,74,74,542,543,543,75,110,110,110,110,74,74,75,74,74,110,110,110,74,74,74,74,75,75,74,148,397,398,399,400,401,362,363,364,365,397,398,399,400,401,147,148,75,111,111,75,40
145,110,74,110,110,542,543,74,74,74,74,74,74,110,74,74,110,110,110,74,110,110,110,110,110,74,75,110,110,110,110,110,110,397,398,399,400,401,110,110,110,110,110,110,110,111,110,110,110,76
477,477,110,110,111,111,111,110,110,110,110,110,110,110,110,110,110,110,110,110,110,110,110,110,110,110,111,110,75,74,74,74,74,75,74,111,111,75,75,110,111,111,75,74,75,110,111,74,75,112
477,477,477,477,148,148,148,148,148,148,148,148,148,148,148,148,148,148,148,148,148,148,148,148,148,148,148,148,148,148,148,148,148,148,148,148,148,148,148,148,148,148,148,148,148,148,148,148,148,148
